[nivel]
origen=mapa1.map
alto=64
ancho=64
mapa=*********************+++++++++++++++++++
     *********************+++++++++++++++++++
     *.....*...*...*...*..+....+......+++++++
     *.....*...*...*...*..+....+......+++++++
     *.....*...*...*...*..+....+......+++++++
     *...*.*...*...*...*..+....+....+++++++++
     *...*.....*...**.....+....+......+++++++
     *...*.....*...**.....+....+......+++++++
     *...*******...**.............+++++++++++
     *.............****.*.............+++++++
     *..................*.............+++++++
     *..................*..++++++++++++++++++
     ***********..*.....*..+......+...+++++++
     *.........*..*.....*..+......+...+++++++
     *............*.*****..+......+...+++++++
     *............*........+......+...+++++++
     *.........*......................+++++++
     *...*...*.*....****.............j+++++++
     *...*...*.*......*..+........+..j+++++++
     *...*...*.*......*..+++++....+..j+++++++
     *...*...*.*......*...........+...+++++++
     ******************.........+++++++++++++
     ********************++++++++++++++++++++
     ********************++++++++++++++++++++
     ********************++++++++++++++++++++



[.]
nombre=vacio
imagen=pasto.png
muro=no

[*]
nombre=arbol
imagen=arbol.png
muro=si

[+]
nombre=ladrillo
imagen=ladrillo.png
muro=si

[j]
nombre=ja
imagen=ja.png
muro=si
